[ ["*","*","*","*","*","*","*","*","*","*","*","*","*","*","*"],
  ["*"," "," "," "," "," "," "," "," "," "," "," "," "," ","*"],
  ["*"," ","*"," ","*"," ","*","*","*","*","*","*","*","*","*"],
  ["*"," ","*"," ","*"," "," "," "," "," "," ","P","*"," ","G"],
  ["*"," ","*"," ","*"," ","*","*"," ","*"," ","*","*"," ","*"],
  ["*"," ","*"," ","*"," ","*","*"," ","*"," ","*","*"," ","*"],
  ["*","*","*"," ","*"," ","*","*"," ","*"," ","*","*"," ","*"],
  ["*"," "," "," ","*"," ","*","*"," ","*"," ","*","*"," ","*"],
  ["*"," ","*"," ","*"," ","*","*"," ","*"," "," "," "," ","*"],
  ["*"," ","*"," ","*"," ","*","*"," ","*","*","*","*","*","*"],
  ["*"," "," "," ","*"," ","*","*"," ","*"," ","*","*","B","*"],
  ["*"," ","*","*","*"," ","*","*"," ","*"," ","*","*"," ","*"],
  ["*"," ","*","S","*"," ","*","*","*","*"," ","*","*"," ","*"],
  ["*","M","*"," "," "," "," "," "," "," "," "," "," "," ","*"],
  ["*","*","*","*","*","*","*","*","*","*","*","*","*","*","*"]]