[["*","*","*","*","*","*","*","*","*","*","*","*","*","*","*"],
 ["*"," "," "," "," "," "," "," "," "," "," "," "," "," ","G"],
 ["*"," ","*"," ","*"," ","*","*","*","*","*","*","*","*","*"],
 ["*"," ","*"," ","*"," "," "," "," "," "," "," ","*"," ","*"],
 ["*"," ","*"," ","*"," ","*","*"," ","*"," ","*","*"," ","*"],
 ["*"," ","*"," ","*"," ","*","*"," ","*"," ","*","*"," ","*"],
 ["*","*","*"," ","*"," ","*","*"," ","*"," ","*","*"," ","*"],
 ["*","P"," "," ","*"," ","*","*"," ","*"," ","*","*"," ","*"],
 ["*"," ","*"," ","*"," ","*","*"," ","*"," "," "," "," ","*"],
 ["*"," ","*"," ","*"," ","*","*"," ","*","*","*","*","*","*"],
 ["*"," "," "," ","*"," ","*","*"," ","*"," ","*","*","B","*"],
 ["*"," ","*","*","*"," ","*","*"," ","*"," ","*","*"," ","*"],
 ["*"," ","*","S","*"," ","*","*","*","*"," ","*","*"," ","*"],
 ["*","M","*"," "," "," "," "," "," "," "," "," "," "," ","*"],
 ["*","*","*","*","*","*","*","*","*","*","*","*","*","*","*"]]